00001000000010
01111011111110
01011110100010
01011010110110
01010010110110
11011110100011
01001010101110
01011111100010
01010000100110
01111111111111
00001000000000